LLLLLLLLLLLLLLLLLLLLLLLLLLLLLL
WWWWWWWWWWWWWWWWWWWWWWWWWWWWWW
TTTTTTTTTTTTTTTTTTTTTTTTTTTTTT
AAAAAAAAAAAAAAAAAAAAAAAAAAAAAA
LLLLLLLLLLLLLLLLLLLLLLLLLLLLLL
WWWWWWWWWWWWWWWWWWWWWWWWWWWWWW
AAAAAAAAAAAAAAAAAAAAAAAAAAAAAA