                    
 LLL            LLL 
 LLLLLLLL  LLLLLLLL 
                    
   A   WWWWWW   A   
   A            A   
       LLLLLL       
   A            A   
   A            A   
   A    TLLLT   A   
        TLBLT       