                    
LTTT     AAA    TTTL
LLL L L  WWW L L LLL
L       LL LL      L
   W LLA  L  ALLW   
L  W         L  W  L
L TTTL L  A  L TTT L
 ALW  AA     AA WLA 
 ALW         W  WLA 
  LL     LLL    LL  
A       LLBLL      A