                    
  LL A LLTLL A  LL  
  LL            LL  
  LL  TTTWWTTT  LL  
  LL  TTTWWTTT  LL  
A                  A
  LL L L L L L  LL  
  TT  L L L L L TT  
  TT            TT  
  LL     LLL    LL  
        LLBLL       