                    
  AA            AA  
  AA            AA  
      LWLWLWLWL     
TTTTTTTTTTTTTTTTTTTT
TTTTTTTTTTTTTTTTTTTT
      LWLWLWLWL     
                    
  A              A  
  AAAA   LLL  AAAA  
         LBL        